


11111111111111111
10C00000010011101
1CCC0111C10110001
10C00111011110C01
11001111EP00C0001
1100C001110CCC001
110CCC011110C01C1
1100C00C000001101
11111111111111111