

11111111111111
1V000000000V01
10C0C0C00C0C01
10CCC0C0CCCCC1
10C0C0C00CCC01
1000000000C001
10000000000001
10P001E0000V01
11111111111111

